Date,Meninggal (baru),Sembuh (baru),Total Kasus,Meninggal,Sembuh,Aktif,Kasus Baru,Persentase Spesimen Positif (Orang),Persentase Penambahan Kasus,Suspek,Spesiment Baru (Orang),Test (Orang),Test (Spesimen),Tingkat Kematian,Tingkat Kesembuhan,Persentase Aktif
2020-03-02,0,0,2,0,0,2,2,0.0,0.0,0,0,0,0,0.0,0.0,1.0
2020-03-03,0,0,2,0,0,2,0,0.0,0.0,0,2,2,0,0.0,0.0,1.0
2020-03-04,0,0,2,0,0,2,0,0.0,0.0,0,31,31,0,0.0,0.0,1.0
2020-03-05,0,0,2,0,0,2,0,0.0,0.0,0,16,16,0,0.0,0.0,1.0
2020-03-06,0,0,4,0,0,4,2,0.03225806451612903,1.0,0,62,62,0,0.0,0.0,1.0
2020-03-07,0,0,4,0,0,4,0,0.0,0.0,0,4,4,0,0.0,0.0,1.0
2020-03-08,0,0,6,0,0,6,2,0.06896551724137931,0.5,0,29,29,0,0.0,0.0,1.0
2020-03-09,0,0,19,0,0,19,13,0.21666666666666667,2.1666666666666665,0,60,60,0,0.0,0.0,1.0
2020-03-10,0,0,27,0,0,27,8,0.052980132450331126,0.42105263157894735,0,151,151,0,0.0,0.0,1.0
2020-03-11,2,2,34,2,2,30,7,0.0707070707070707,0.25925925925925924,0,99,99,0,0.05882352941176471,0.05882352941176471,0.8823529411764706
2020-03-12,2,1,34,4,3,27,0,0.0,0.0,0,69,69,0,0.1176470588235294,0.08823529411764706,0.7941176470588235
2020-03-13,0,2,69,4,5,60,35,0.2447552447552448,1.0294117647058822,0,143,143,0,0.05797101449275361,0.07246376811594203,0.8695652173913043
2020-03-14,1,3,96,5,8,83,27,0.135,0.39130434782608703,0,200,200,0,0.052083333333333336,0.08333333333333333,0.8645833333333334
2020-03-15,0,0,117,5,8,104,21,0.23863636363636365,0.21875,0,88,88,0,0.042735042735042736,0.06837606837606837,0.8888888888888888
2020-03-16,0,0,134,5,8,121,17,-0.2698412698412698,0.1452991452991453,0,-63,-63,0,0.037313432835820885,0.05970149253731344,0.9029850746268656
2020-03-17,2,1,172,7,9,156,38,0.2676056338028169,0.2835820895522388,0,142,142,0,0.040697674418604654,0.05232558139534884,0.9069767441860463
2020-03-18,12,2,227,19,11,197,55,0.25,0.31976744186046513,0,220,220,0,0.08370044052863436,0.048458149779735685,0.8678414096916299
2020-03-19,6,4,309,25,15,269,82,0.2679738562091503,0.3612334801762114,0,306,306,0,0.08090614886731391,0.04854368932038835,0.8705501618122977
2020-03-20,7,1,369,32,16,321,60,0.4615384615384616,0.1941747572815534,0,130,130,0,0.08672086720867209,0.043360433604336036,0.8699186991869918
2020-03-21,6,4,450,38,20,392,81,0.2403560830860534,0.2195121951219512,0,337,337,0,0.08444444444444445,0.04444444444444445,0.8711111111111111
2020-03-22,10,9,514,48,29,437,64,0.8767123287671232,0.14222222222222222,0,73,73,0,0.0933852140077821,0.05642023346303503,0.8501945525291829
2020-03-23,1,1,579,49,30,500,65,0.20440251572327045,0.1264591439688716,0,318,318,0,0.0846286701208981,0.05181347150259067,0.8635578583765112
2020-03-24,6,0,685,55,30,600,106,0.1840277777777778,0.1830742659758204,0,576,576,0,0.08029197080291971,0.043795620437956206,0.8759124087591241
2020-03-25,3,1,790,58,31,701,105,0.21428571428571427,0.15306122448979592,0,490,490,0,0.07341772151898733,0.039240506329113925,0.8873417721518987
2020-03-26,20,4,893,78,35,780,103,0.2003891050583657,0.13037974683544304,0,514,514,0,0.08734602463605823,0.03919372900335946,0.8734602463605823
2020-03-27,9,11,1046,87,46,913,153,0.1063238359972203,0.1713325867861142,0,1439,1439,0,0.08317399617590822,0.04397705544933078,0.872848948374761
2020-03-28,15,13,1155,102,59,994,109,0.2219959266802444,0.10420650095602296,0,491,491,0,0.08831168831168831,0.05108225108225108,0.8606060606060606
2020-03-29,12,5,1285,114,64,1107,130,0.4850746268656717,0.11255411255411256,0,268,268,0,0.088715953307393,0.04980544747081712,0.8614785992217899
2020-03-30,8,11,1414,122,75,1217,129,1.0,0.10038910505836576,0,129,129,0,0.08628005657708628,0.05304101838755304,0.8606789250353607
2020-03-31,14,6,1528,136,81,1311,114,1.0,0.08062234794908063,0,114,114,0,0.08900523560209424,0.05301047120418848,0.8579842931937173
2020-04-01,21,22,1677,157,103,1417,149,0.3581730769230769,0.0975130890052356,0,416,416,0,0.0936195587358378,0.06141920095408467,0.8449612403100775
2020-04-02,13,9,1790,170,112,1508,113,0.4870689655172414,0.06738223017292785,0,232,232,0,0.09497206703910614,0.06256983240223464,0.8424581005586592
2020-04-03,11,22,1986,181,134,1671,196,0.3493761140819964,0.1094972067039106,0,561,561,0,0.09113796576032224,0.06747230614300101,0.8413897280966768
2020-04-04,10,16,2092,191,150,1751,106,0.06141367323290847,0.05337361530715005,0,1726,1726,0,0.0913001912045889,0.07170172084130019,0.8369980879541109
2020-04-05,7,14,2273,198,164,1911,181,0.11830065359477125,0.08652007648183556,0,1530,1530,0,0.08710954685437748,0.07215134183897932,0.8407391113066432
2020-04-06,11,28,2491,209,192,2090,218,0.11213991769547324,0.09590849098108227,0,1944,1944,0,0.08390204737053393,0.07707747892412686,0.8390204737053393
2020-04-07,12,12,2738,221,204,2313,247,0.21165381319622964,0.09915696507426736,0,1167,1167,0,0.08071585098612126,0.07450693937180422,0.8447772096420745
2020-04-08,19,18,2956,240,222,2494,218,0.1010194624652456,0.07962016070124177,0,2158,2158,0,0.08119079837618404,0.07510148849797023,0.8437077131258457
2020-04-09,40,30,3293,280,252,2761,337,0.288527397260274,0.11400541271989174,0,1168,1168,0,0.08502884907379289,0.07652596416641361,0.8384451867597935
2020-04-10,26,30,3512,306,282,2924,219,0.12351945854483926,0.06650470695414516,0,1773,1773,0,0.08712984054669702,0.08029612756264237,0.8325740318906606
2020-04-11,21,4,3842,327,286,3229,330,0.64453125,0.09396355353075173,0,512,512,0,0.08511192087454451,0.07444039562727746,0.840447683498178
2020-04-12,46,73,4241,373,359,3509,399,0.05611025172268317,0.10385216033315982,0,7111,7111,0,0.08795095496345201,0.08464984673426079,0.8273991983022871
2020-04-13,26,21,4557,399,380,3778,316,0.35990888382687924,0.07451072860174487,0,878,878,0,0.08755760368663594,0.08338819398727232,0.8290542023260917
2020-04-14,60,46,4839,459,426,3954,282,0.07673469387755102,0.06188281764318631,149619,3675,3675,0,0.09485430874147552,0.08803471791692498,0.8171109733415995
2020-04-15,10,20,5136,469,446,4221,297,0.21631463947560087,0.061376317420954736,176714,1373,1373,0,0.09131619937694704,0.08683800623052959,0.8218457943925234
2020-04-16,27,102,5516,496,548,4472,380,0.19250253292806485,0.07398753894080996,181319,1974,1974,3275,0.08992023205221175,0.09934735315445976,0.8107324147933285
2020-04-17,24,59,5923,520,607,4796,407,0.1885132005558129,0.07378535170413343,186342,2159,2159,2402,0.08779334796555799,0.10248185041364173,0.8097248016208003
2020-04-18,15,24,6248,535,631,5082,325,0.14204545454545456,0.05487084247847375,189323,2288,2288,3270,0.08562740076824582,0.10099231754161332,0.8133802816901409
2020-04-19,47,55,6575,582,686,5307,327,0.11691097604576332,0.052336747759282966,194529,2797,2797,2100,0.0885171102661597,0.10433460076045628,0.8071482889733841
2020-04-20,8,60,6760,590,746,5424,185,0.12091503267973855,0.02813688212927757,198113,1530,1530,2289,0.08727810650887574,0.11035502958579882,0.8023668639053254
2020-04-21,26,96,7135,616,842,5677,375,0.1547029702970297,0.05547337278106509,203093,2424,2424,603,0.08633496846531184,0.11800981079187105,0.7956552207428171
2020-04-22,19,71,7418,635,913,5870,283,0.2382154882154882,0.039663629992992284,211325,1188,1188,5362,0.08560258829873281,0.12307899703424105,0.7913184146670261
2020-04-23,12,47,7775,647,960,6168,357,0.2776049766718507,0.04812617956322459,214231,1286,1286,4203,0.08321543408360127,0.12347266881028934,0.7933118971061093
2020-04-24,42,42,8211,689,1002,6520,436,0.22755741127348644,0.05607717041800643,216252,1916,1916,4119,0.08391182559980515,0.12203142126415785,0.7940567531360371
2020-04-25,31,40,8607,720,1042,6845,396,0.2002022244691608,0.04822798684691268,225995,1978,1978,3774,0.08365284071104914,0.12106425002904612,0.7952829092599047
2020-04-26,23,65,8882,743,1107,7032,275,0.0620347394540943,0.03195073777158127,228688,4433,4433,4271,0.08365233055618104,0.12463409142085115,0.7917135780229678
2020-04-27,22,44,9096,765,1151,7180,214,0.08788501026694047,0.024093672596262102,230186,2435,2435,3058,0.08410290237467019,0.1265391380826737,0.7893579595426561
2020-04-28,8,103,9511,773,1254,7484,415,0.13237639553429026,0.04562445030782762,234072,3135,3135,4461,0.0812743139522658,0.1318473346651246,0.7868783513826096
2020-04-29,11,137,9771,784,1391,7596,260,0.049618320610687015,0.027336767952896645,243403,5240,5240,7367,0.0802374373145021,0.14236004503121485,0.7774025176542829
2020-04-30,8,131,10118,792,1522,7804,347,0.0730987992416263,0.0355132535052707,252238,4747,4747,7614,0.07827633919746986,0.15042498517493574,0.7712986756275944
2020-05-01,8,69,10551,800,1591,8160,433,0.10806089343648614,0.04279501877841471,255243,4007,4007,7706,0.07582219694815658,0.15079139418064638,0.7733864088711969
2020-05-02,31,74,10843,831,1665,8347,292,0.08768768768768767,0.02767510188607715,257580,3330,3330,5638,0.07663930646500046,0.15355528912662547,0.7698054044083741
2020-05-03,14,211,11192,845,1876,8471,349,0.11100508905852416,0.0321866642073227,259499,3144,3144,5022,0.07550035739814152,0.16761972837741246,0.756879914224446
2020-05-04,19,78,11587,864,1954,8769,395,0.12955067235159068,0.035293066476054326,262198,3049,3049,3896,0.07456632432898938,0.16863726590144126,0.7567964097695693
2020-05-05,8,243,12071,872,2197,9002,484,0.16905344044708348,0.041770950202813496,265634,2863,2863,4686,0.07223925109767211,0.1820064617678734,0.7457542871344545
2020-05-06,23,120,12438,895,2317,9226,367,0.0905725567620928,0.03040344627619916,267658,4052,4052,6836,0.07195690625502492,0.18628396848367906,0.7417591252612961
2020-05-07,35,64,12776,930,2381,9465,338,0.09035017375033412,0.027174786943238462,271963,3741,3741,5768,0.07279273638071382,0.18636505948653725,0.7408422041327489
2020-05-08,13,113,13112,943,2494,9675,336,0.050571944611679714,0.026299311208515967,273567,6644,6644,9630,0.07191885295912141,0.19020744356314825,0.7378737034777303
2020-05-09,16,113,13645,959,2607,10079,533,0.09985013113525663,0.04064978645515558,276537,5338,5338,7106,0.07028215463539758,0.1910589959692195,0.738658849395383
2020-05-10,14,91,14032,973,2698,10361,387,0.08142225962549969,0.028362037376328326,279007,4753,4753,7386,0.06934150513112884,0.19227480045610035,0.7383836944127709
2020-05-11,18,183,14265,991,2881,10393,233,0.08017894012388163,0.01660490307867731,281099,2906,2906,3078,0.06947073256221521,0.20196284612688395,0.7285664213109008
2020-05-12,16,182,14749,1007,3063,10679,484,0.14362017804154306,0.0339291973361374,284008,3370,3370,3777,0.0682758153095125,0.2076750966167198,0.7240490880737677
2020-05-13,21,224,15438,1028,3287,11123,689,0.17924037460978148,0.04671503152756119,289341,3844,3844,4067,0.06658893639072419,0.21291618085244196,0.7204948827568338
2020-05-14,15,231,16006,1043,3518,11445,568,0.13393067672718698,0.036792330612773684,292311,4241,4241,4495,0.06516306385105586,0.21979257778333125,0.7150443583656129
2020-05-15,33,285,16496,1076,3803,11617,490,0.11537555921827172,0.03061351993002624,297279,4247,4247,4912,0.06522793404461688,0.2305407371483996,0.7042313288069835
2020-05-16,13,108,17025,1089,3911,12025,529,0.1442989634478996,0.03206838021338506,304518,3666,3666,4216,0.0639647577092511,0.2297209985315712,0.7063142437591777
2020-05-17,59,218,17514,1148,4129,12237,489,0.10301242890246473,0.028722466960352425,306676,4747,4747,5147,0.06554756195043965,0.23575425373986525,0.6986981843096951
2020-05-18,43,195,18010,1191,4324,12495,496,0.19359875097580007,0.028320200982071487,56469,2562,2562,2695,0.06612992781787895,0.24008883953359245,0.6937812326485286
2020-05-19,30,143,18496,1221,4467,12808,486,0.10201511335012596,0.026985008328706275,57191,4764,4764,12276,0.06601427335640138,0.24151167820069205,0.6924740484429066
2020-05-20,21,108,19189,1242,4575,13372,693,0.10930599369085174,0.03746756055363322,56408,6340,6340,8947,0.06472458179165147,0.2384178435562041,0.6968575746521445
2020-05-21,36,263,20162,1278,4838,14046,973,0.15605453087409785,0.05070613372244515,61253,6235,6235,8092,0.0633865687927785,0.23995635353635555,0.6966570776708659
2020-05-22,48,219,20796,1326,5057,14413,634,0.07376381617219313,0.03144529312568198,58178,8595,8595,9359,0.06376226197345643,0.2431717638007309,0.6930659742258126
2020-05-23,25,192,21745,1351,5249,15145,949,0.1343051231248231,0.04563377572610117,61453,7066,7066,10406,0.06212922510922051,0.2413888250172453,0.6964819498735342
2020-05-24,21,153,22271,1372,5402,15497,526,0.13387630440315598,0.02418946884341228,53940,3929,3929,8815,0.061604777513358175,0.2425575860985137,0.6958376363881279
2020-05-25,19,240,22750,1391,5642,15717,479,0.14838909541511772,0.021507790400071843,61703,3228,3228,8391,0.06114285714285715,0.248,0.6908571428571428
2020-05-26,27,235,23165,1418,5877,15870,415,0.0812133072407045,0.018241758241758242,77770,5110,5110,7152,0.06121303690913015,0.2537017051586445,0.6850852579322253
2020-05-27,55,180,23851,1473,6057,16321,686,0.09506651884700663,0.02961364126915605,62609,7216,7216,14313,0.06175841683786841,0.2539516162844325,0.684289966877699
2020-05-28,23,183,24538,1496,6240,16802,687,0.11859140341791816,0.02880382373904658,61999,5793,5793,11495,0.060966663949792166,0.254299453908224,0.6847338821419838
2020-05-29,24,252,25216,1520,6492,17204,678,0.17592112091333678,0.02763061374195126,61711,3854,3854,10639,0.06027918781725888,0.2574555837563452,0.6822652284263959
2020-05-30,53,523,25773,1573,7015,17185,557,0.04800068941744226,0.02208914974619289,60546,11604,11604,11361,0.06103286384976527,0.27218406859892136,0.6667830675513133
2020-05-31,40,293,26473,1613,7308,17552,700,0.10211524434719182,0.02716020641756877,62849,6855,6855,11470,0.06093000415517698,0.2760548483360405,0.6630151475087825
2020-06-01,28,329,26940,1641,7637,17662,467,0.05501236894805042,0.01764061496619197,61478,8489,8489,10039,0.06091314031180401,0.28348181143281365,0.6556050482553823
2020-06-02,22,298,27549,1663,7935,17951,609,0.1043880699348646,0.022605790645879732,61236,5834,5834,9049,0.060365167519692176,0.2880322334748993,0.6516025990054085
2020-06-03,35,471,28233,1698,8406,18129,684,0.08060334668866369,0.02482848742241097,61438,8486,8486,11970,0.060142386568908725,0.2977366911061524,0.6421209223249389
2020-06-04,23,486,28818,1721,8892,18205,585,0.11031491608523478,0.020720433535224736,60789,5303,5303,13206,0.05971961968214313,0.30855715178013743,0.6317232285377195
2020-06-05,49,551,29521,1770,9443,18308,703,0.13854946787544345,0.024394475674925392,62912,5074,5074,13333,0.059957318519020364,0.3198739880085363,0.6201686934724433
2020-06-06,31,464,30514,1801,9907,18806,993,0.12522068095838587,0.03363707191490803,59918,7930,7930,13095,0.05902208822179982,0.3246706429835485,0.6163072687946516
2020-06-07,50,591,31186,1851,10498,18837,672,0.1525192918747163,0.022022678114963626,54567,4406,4406,11924,0.0593535560828577,0.3366254088372988,0.6040210350798435
2020-06-08,32,406,32033,1883,10904,19246,847,0.16029523088569267,0.027159622907715,52801,5284,5284,6988,0.058783129897293424,0.3403989635688197,0.6008179065338869
2020-06-09,40,510,33076,1923,11414,19739,1043,0.14439983386404542,0.032560172322292635,52502,7223,7223,16181,0.05813883178135204,0.3450840488571774,0.5967771193614706
2020-06-10,36,715,34316,1959,12129,20228,1240,0.2128755364806867,0.03748941830934817,58187,5825,5825,17757,0.05708707308544119,0.3534502855810701,0.5894626413334888
2020-06-11,41,507,35295,2000,12636,20659,979,0.13610454608647296,0.0285289660799627,57466,7193,7193,16702,0.056665250035415775,0.3580110497237569,0.5853237002408274
2020-06-12,48,577,36406,2048,13213,21145,1111,0.14860888175494916,0.03147754639467347,51461,7476,7476,15333,0.05625446354996429,0.36293468109652255,0.5808108553535132
2020-06-13,43,563,37420,2091,13776,21553,1014,0.0911214953271028,0.027852551777179584,56028,11128,11128,16574,0.055879208979155534,0.3681453768038481,0.5759754142169963
2020-06-14,43,755,38277,2134,14531,21612,857,0.0887347276868917,0.0229021913415286,55213,9658,9658,18760,0.05575149567625467,0.37962745251717744,0.564621051806568
2020-06-15,64,592,39294,2198,15123,21973,1017,0.16253795748761388,0.026569480366799902,50393,6257,6257,8776,0.05593729322542882,0.38486791876622384,0.5591947880083473
2020-06-16,33,580,40400,2231,15703,22466,1106,0.10929933787923707,0.028146790858655263,42634,10119,10119,17052,0.055222772277227716,0.3886881188118812,0.5560891089108911
2020-06-17,45,540,41431,2276,16243,22912,1031,0.11495149960976694,0.02551980198019801,55993,8969,8969,19757,0.05493471072385412,0.392049431585045,0.5530158576911008
2020-06-18,63,555,42762,2339,16798,23625,1331,0.12821500818803586,0.032125702976032434,54621,10381,10381,20650,0.05469809644076516,0.3928254057340629,0.5524764978251718
2020-06-19,34,551,43803,2373,17349,24081,1041,0.13140621055289067,0.02434404377718535,49675,7922,7922,20717,0.0541743716183823,0.3960687624135333,0.5497568659680844
2020-06-20,56,534,45029,2429,17883,24717,1226,0.12337727684411795,0.02798895052850261,50486,9937,9937,19917,0.05394301450176553,0.3971440627151391,0.5489129227830953
2020-06-21,36,521,45891,2465,18404,25022,862,0.1308638226810384,0.01914321881454174,69661,6587,6587,18229,0.053714235906822685,0.40103724041751104,0.5452485236756662
2020-06-22,35,331,46845,2500,18735,25610,954,0.09528565721134638,0.0207883898803687,56499,10012,10012,10926,0.05336748852598997,0.3999359590137688,0.5466965524602412
2020-06-23,35,506,47896,2535,19241,26120,1051,0.12272302662307333,0.022435692176326183,49331,8564,8564,17908,0.052927175547018535,0.4017245699014532,0.5453482545515284
2020-06-24,38,417,49009,2573,19658,26778,1113,0.09094623304461512,0.023237848672122932,49717,12238,12238,21233,0.05250056112142668,0.40111000020404414,0.5463894386745292
2020-06-25,47,791,50187,2620,20449,27118,1178,0.08897953017599516,0.024036401477279683,50617,13239,13239,19510,0.05220475421922011,0.40745611413314203,0.5403391316476378
2020-06-26,63,884,51427,2683,21333,27411,1240,0.09726253039454076,0.02470759359993624,51887,12749,12749,22819,0.05217103855951154,0.4148210084197017,0.5330079530207867
2020-06-27,37,576,52812,2720,21909,28183,1385,0.14334506313392673,0.02693137845878624,54063,9662,9662,21589,0.05150344618647277,0.4148488979777323,0.5336476558357949
2020-06-28,34,1027,54010,2754,22936,28320,1198,0.1695203056459601,0.022684238430659698,62370,7067,7067,17230,0.050990557304202926,0.4246620996111831,0.524347343084614
2020-06-29,51,864,55092,2805,23800,28487,1082,0.11959765668177295,0.02003332716163673,54940,9047,9047,11783,0.05091483336963625,0.4320046467726712,0.5170805198576925
2020-06-30,71,1006,56385,2876,24806,28703,1293,0.11113021057155137,0.0234698322805489,56979,11635,11635,21515,0.05100647335284207,0.4399397002748958,0.5090538263722622
2020-07-01,58,789,57770,2934,25595,29241,1385,0.09233333333333334,0.02456327037332624,58488,15000,15000,21738,0.05078760602388783,0.4430500259650337,0.5061623680110784
2020-07-02,53,1072,59394,2987,26667,29740,1624,0.15017569816904014,0.02811147654491951,54137,10814,10814,23519,0.05029127521298448,0.4489847459339327,0.5007239788530828
2020-07-03,49,901,60695,3036,27568,30091,1301,0.07726570851645087,0.021904569485133186,52376,16838,16838,22281,0.05002059477716452,0.4542054534969932,0.4957739517258423
2020-07-04,53,651,62142,3089,28219,30834,1447,0.14919063821012474,0.023840514045638025,53095,9699,9699,22992,0.04970873161468894,0.4541051140935277,0.4961861542917833
2020-07-05,82,886,63749,3171,29105,31473,1607,0.1529602132114982,0.02586012680634676,53695,10506,10506,21054,0.04974195673657626,0.4565561812734317,0.4937018619899921
2020-07-06,70,814,64958,3241,29919,31798,1209,0.10151985893022084,0.01896500337260193,52108,11909,11909,12756,0.04989377751778072,0.460589919640383,0.4895163028418363
2020-07-07,68,866,66226,3309,30785,32132,1268,0.11878220140515222,0.019520305428122785,52173,10675,10675,17816,0.04996527043759249,0.4648476429196992,0.4851870866427083
2020-07-08,50,800,68079,3359,31585,33135,1853,0.1450262189872427,0.027979947452662097,52134,12777,12777,22183,0.04933973765772119,0.4639462976835735,0.4867139646587053
2020-07-09,58,1066,70736,3417,32651,34668,2657,0.21181441326530606,0.03902818784059695,52230,12544,12544,23832,0.04830637864736485,0.4615895724949106,0.4901040488577245
2020-07-10,52,878,72347,3469,33529,35349,1611,0.1716020451640392,0.02277482470029405,52587,9388,9388,23609,0.0479494657691404,0.4634469984933722,0.4886035357374874
2020-07-11,66,1190,74018,3535,34719,35764,1671,0.13235643564356436,0.023097018535668368,48639,12625,12625,23310,0.04775865330054852,0.4690615796157692,0.4831797670836823
2020-07-12,71,919,75699,3606,35638,36455,1681,0.15290158268146262,0.02271069199383933,49001,10994,10994,22379,0.04763603218008164,0.4707856114347613,0.481578356385157
2020-07-13,50,1051,76981,3656,36689,36636,1282,0.14146987419995585,0.01693549452436624,46943,9062,9062,13100,0.047492238344526566,0.4765981216144243,0.4759096400410491
2020-07-14,54,947,78572,3710,37636,37226,1591,0.13241781106949646,0.020667437419623024,46701,12015,12015,23001,0.047217838415720616,0.4790001527261621,0.4737820088581174
2020-07-15,87,1414,80094,3797,39050,37247,1522,0.09825059712090893,0.019370768212594817,47859,15491,15491,24871,0.047406797013509125,0.4875521262516543,0.4650410767348366
2020-07-16,76,1295,81668,3873,40345,37450,1574,0.1294833826916749,0.019651909006916872,46727,12156,12156,23947,0.047423715531175005,0.4940123426556301,0.4585639418131949
2020-07-17,84,1489,83130,3957,41834,37339,1462,0.10447334571959413,0.01790174854288093,46493,13994,13994,29176,0.04760014435221942,0.503235895585228,0.4491639600625526
2020-07-18,59,1434,84882,4016,43268,37598,1752,0.1323462758724883,0.021075424034644533,37593,13238,13238,25552,0.04731274003911312,0.5097429372540704,0.4429443227068165
2020-07-19,127,2133,86521,4143,45401,36977,1639,0.1607650809220206,0.019309158596640043,37505,10195,10195,20504,0.04788432866009408,0.5247396585799979,0.427376012759908
2020-07-20,96,1576,88214,4239,46977,36998,1693,0.1276868542122332,0.019567503842997654,36380,13259,13259,14027,0.04805359693472691,0.5325345183304238,0.41941188473484936
2020-07-21,81,1489,89869,4320,48466,37083,1655,0.09540554562748604,0.01876119436824087,44003,17347,17347,22262,0.0480699685097197,0.5392960865259433,0.412633944964337
2020-07-22,139,1789,91751,4459,50255,37037,1882,0.1597351892717705,0.020941592762799187,44222,11782,11782,25302,0.048598925352312236,0.5477324497825636,0.4036686248651241
2020-07-23,117,1909,93657,4576,52164,36917,1906,0.14297502062861,0.02077361554642456,47756,13331,13331,27815,0.04885913492851576,0.5569685127646625,0.3941723523068217
2020-07-24,89,1781,95418,4665,53945,36808,1761,0.12451389379905252,0.01880265223101317,53702,14143,14143,24965,0.0488901465132365,0.5653545452639963,0.3857553082227672
2020-07-25,49,1409,97286,4714,55354,37218,1868,0.1536436913966113,0.01957701901108805,54752,12158,12158,25318,0.048455070616532696,0.5689821762637995,0.3825627531196678
2020-07-26,67,1301,98778,4781,56655,37342,1492,0.1939677587103484,0.015336225150586929,55647,7692,7692,20492,0.04840146591346251,0.5735588896312944,0.3780396444552431
2020-07-27,57,1518,100303,4838,58173,37292,1525,0.13868679519825391,0.015438660430460225,54910,10996,10996,13060,0.0482338514301666,0.5799726827712033,0.37179346579863015
2020-07-28,63,2366,102051,4901,60539,36611,1748,0.11483379319406126,0.01742719559734006,46646,15222,15222,22563,0.048025007104290994,0.5932229963449648,0.35875199655074425
2020-07-29,74,1599,104432,4975,62138,37319,2381,0.1333221344980122,0.023331471519142388,57393,17859,17859,30261,0.04763865481844645,0.5950091925846483,0.3573521525969052
2020-07-30,83,2154,106336,5058,64292,36986,1904,0.12713675213675213,0.018231959552627547,53723,14976,14976,30046,0.04756620523623232,0.6046117965693649,0.3478219981944026
2020-07-31,73,1615,108376,5131,65907,37338,2040,0.19362186788154892,0.0191844718627746,60739,10536,10536,28562,0.047344430501217984,0.6081327969292094,0.3445227725695726
2020-08-01,62,2012,109936,5193,67919,36824,1560,0.16675574559059328,0.014394330848158263,57816,9355,9355,11190,0.0472365740066948,0.6178049046718089,0.3349585213214961
2020-08-02,43,1056,111455,5236,68975,37244,1519,0.2352121399814184,0.013817129966525978,62366,6458,6458,20032,0.046978601229195636,0.618859629446862,0.3341617693239424
2020-08-03,66,1262,113134,5302,70237,37595,1679,0.13786025125215534,0.015064375757031984,77572,12179,12179,14728,0.046864779818622165,0.6208301659978432,0.33230505418353457
2020-08-04,86,1813,115056,5388,72050,37618,1922,0.1428359096313912,0.01698870366114519,68131,13456,13456,22902,0.046829370045890696,0.6262167987762481,0.3269538311778612
2020-08-05,64,1839,116871,5452,73889,37530,1815,0.12328487977177012,0.015774926992073425,94593,14722,14722,28738,0.04664972491037126,0.6322269853085881,0.32112328978104066
2020-08-06,69,1756,118753,5521,75645,37587,1882,0.14020710720405274,0.016103224923205928,91219,13423,13423,29375,0.04649145705792696,0.6369944338248297,0.31651410911724337
2020-08-07,72,1912,121226,5593,77557,38076,2473,0.15673722905311194,0.02082473705927429,80200,15778,15778,30159,0.04613696731724218,0.6397719961064459,0.314091036576312
2020-08-08,65,1749,123503,5658,79306,38539,2277,0.1947485460143688,0.018783099335126133,83624,11692,11692,30565,0.04581265232423504,0.6421382476539031,0.3120491000218618
2020-08-09,65,1646,125396,5723,80952,38721,1893,0.21052046263345195,0.015327562893209072,87224,8992,8992,21918,0.0456394143353855,0.6455708316054739,0.30878975405914066
2020-08-10,42,1284,127083,5765,82236,39082,1687,0.1371656232214001,0.013453379693132156,84139,12299,12299,15836,0.0453640534139106,0.6471046481433393,0.30753129844275
2020-08-11,59,1474,128776,5824,83710,39242,1693,0.1252867608969141,0.013322002156071228,85928,13513,13513,25791,0.04522581847549234,0.6500434863639187,0.3047306951605889
2020-08-12,79,2088,130718,5903,85798,39017,1942,0.14177252153599065,0.015080449773249675,86619,13698,13698,26248,0.04515827965544148,0.6563594914242874,0.2984822289202711
2020-08-13,65,1760,132816,5968,87558,39290,2098,0.14127946127946128,0.016049817163665294,76515,14850,14850,25814,0.04493434525960728,0.6592428623057462,0.29582279243464643
2020-08-14,53,2060,135123,6021,89618,39484,2307,0.1812539283469516,0.0173698951933502,75527,12728,12728,26018,0.0445594014342488,0.6632327583016955,0.2922078402640557
2020-08-15,50,1703,137468,6071,91321,40076,2345,0.182903049684112,0.017354558439347852,76327,12821,12821,27296,0.04416300520848488,0.6643073297058224,0.2915296650856927
2020-08-16,79,1782,139549,6150,93103,40296,2081,0.22575395964417444,0.015138068495940871,77090,9218,9218,25414,0.0440705415302152,0.6671706712337602,0.2887587872360246
2020-08-17,57,1355,141370,6207,94458,40705,1821,0.2520764119601329,0.013049179857971036,78659,7224,7224,12453,0.04390606210652897,0.6681615618589517,0.2879323760345193
2020-08-18,70,1848,143043,6277,96306,40460,1673,0.13482150052381334,0.01183419395911438,78394,12409,12409,14371,0.04388190963556413,0.6732660808288417,0.2828520095355942
2020-08-19,69,2351,144945,6346,98657,39942,1902,0.12730923694779114,0.013296700992009395,79174,14940,14940,26078,0.04378212425402739,0.6806512815205767,0.2755665942253959
2020-08-20,72,2017,147211,6418,100674,40119,2266,0.19245795821301173,0.015633516161302558,79484,11774,11774,28824,0.04359728552893466,0.6838755256061028,0.2725271888649625
2020-08-21,82,2317,149408,6500,102991,39917,2197,0.16233190483227428,0.014924156482871525,78877,13534,13534,19929,0.04350503319768687,0.6893272113943029,0.2671677554080103
2020-08-22,94,2207,151498,6594,105198,39706,2090,0.11505009358141585,0.01398854144356393,75457,18166,18166,24749,0.043525327067023986,0.6943854044277812,0.2620892685051948
2020-08-23,86,2302,153535,6680,107500,39355,2037,0.11696141479099678,0.013445722055736707,75522,17416,17416,22152,0.04350799491972514,0.7001660859087504,0.2563259191715244
2020-08-24,79,3560,155412,6759,111060,37593,1877,0.11597157862218105,0.012225225518611393,76745,16185,16185,19395,0.04349085012740329,0.7146166319203149,0.2418925179522817
2020-08-25,99,1807,157859,6858,112867,38134,2447,0.1317078421874159,0.015745244897433914,76667,18579,18579,21275,0.04344383278748757,0.7149861585338815,0.2415700086786309
2020-08-26,86,2542,160165,6944,115409,37812,2306,0.11237816764132554,0.014607972937874941,77056,20520,20520,29312,0.04335528985733463,0.7205631692317298,0.2360815409109356
2020-08-27,120,3166,162884,7064,118575,37245,2719,0.12936530592825196,0.01697624324914931,76201,21018,21018,29663,0.04336828663343238,0.7279720537314899,0.2286596596350777
2020-08-28,105,2325,165887,7169,120900,37818,3003,0.18037119346507294,0.018436433289948675,77857,16649,16649,33082,0.04321616522090339,0.7288093702339544,0.2279744645451421
2020-08-29,92,1902,169195,7261,122802,39132,3308,0.15628838703581216,0.019941285332786773,76252,21166,21166,28905,0.04291497975708502,0.7258015898814977,0.2312834303614173
2020-08-30,82,1383,172053,7343,124185,40525,2858,0.2525404259079261,0.016891752120334527,77951,11317,11317,25934,0.04267870946743155,0.7217834039511081,0.23553788658146035
2020-08-31,74,1774,174796,7417,125959,41420,2743,0.1883152547027324,0.015942761823391632,79320,14566,14566,15305,0.04243232110574613,0.7206057346850042,0.23696194420924965
2020-09-01,88,2098,177571,7505,128057,42009,2775,0.1814555679068855,0.015875649328359918,80675,15293,15293,30625,0.04226478422715421,0.7211594235545219,0.23657579221832395
2020-09-02,111,1914,180646,7616,129971,43059,3075,0.14297005765296633,0.017317016855229742,81757,21508,21508,31001,0.04215980425805167,0.7194789809904454,0.2383612147515029
2020-09-03,134,2084,184268,7750,132055,44463,3622,0.18761006940847405,0.02005026405234547,84701,19306,19306,37597,0.04205830637983806,0.7166464063212278,0.2412952872989341
2020-09-04,82,2126,187537,7832,134181,45524,3269,0.18060773480662984,0.017740464974927823,85178,18100,18100,36268,0.04176242554802519,0.7154908098135301,0.2427467646384447
2020-09-05,108,2220,190665,7940,136401,46324,3128,0.1851216192223472,0.01667937526994673,86778,16897,16897,30640,0.041643720661893896,0.7153961136023916,0.2429601657357145
2020-09-06,85,2174,194109,8025,138575,47509,3444,0.26041587901701324,0.01806309495712375,89701,13225,13225,27979,0.041342750722532184,0.7139030132554389,0.2447542360220289
2020-09-07,105,2077,196989,8130,140652,48207,2880,0.1779865274086892,0.01483702455836669,89992,16181,16181,18412,0.041271340024062256,0.7140094116930387,0.24471924828289904
2020-09-08,100,2306,200035,8230,142958,48847,3046,0.18349397590361446,0.015462792338658504,90952,16600,16600,32643,0.04114280000999825,0.7146649336366135,0.2441922663533881
2020-09-09,106,2242,203342,8336,145200,49806,3307,0.2156504727746984,0.016532106881295774,92330,15335,15335,29863,0.0409949739847154,0.7140679249736896,0.2449371010415949
2020-09-10,120,2310,207203,8456,147510,51237,3861,0.19006596435955492,0.018987715277709483,95501,20314,20314,34909,0.04081021992924813,0.7119105418357843,0.24727923823496764
2020-09-11,88,2707,210940,8544,150217,52179,3737,0.13182122826201986,0.0180354531546358,94886,28349,28349,31864,0.04050440883663601,0.7121314117758605,0.24736417938750355
2020-09-12,106,2241,214746,8650,152458,53638,3806,0.15271647540325814,0.01804304541575804,95539,24922,24922,38561,0.04028014491538842,0.7099457032959869,0.2497741517886247
2020-09-13,73,2552,218382,8723,155010,54649,3636,0.13910781238044226,0.016931630856919337,97227,26138,26138,30100,0.03994376825928877,0.709811248179795,0.2502449835609162
2020-09-14,118,3395,221523,8841,158405,54277,3141,0.15554895260733914,0.014383053548369369,98842,20193,20193,22606,0.0399100770574613,0.7150724755443001,0.2450174473982385
2020-09-15,124,2660,225030,8965,161065,55000,3507,0.1557905024210386,0.015831313227068967,99634,22511,22511,42636,0.039839132560103095,0.7157490112429454,0.2444118561969515
2020-09-16,135,3036,228993,9100,164101,55792,3963,0.1290333083710481,0.01761098520197307,100236,30713,30713,39774,0.03973920600193018,0.7166201586948072,0.2436406353032625
2020-09-17,122,2585,232628,9222,166686,56720,3635,0.12299103366604636,0.015873847672199588,103209,29555,29555,41804,0.03964269133552281,0.7165345530202727,0.2438227556442045
2020-09-18,114,4088,236519,9336,170774,56409,3891,0.15996546620621607,0.01672627542686177,104866,24324,24324,44428,0.0394725159500928,0.7220307882242019,0.2384966958257053
2020-09-19,112,3576,240687,9448,174350,56889,4168,0.1933747796232718,0.017622262904882904,107863,21554,21554,44543,0.03925430122939751,0.7243847818951584,0.23636091687544405
2020-09-20,105,2977,244676,9553,177327,57796,3989,0.19971962148901007,0.016573391998736947,107370,19973,19973,36753,0.03904346973139989,0.7247421079304877,0.2362144223381125
2020-09-21,124,3470,248852,9677,180797,58378,4176,0.16821752265861029,0.017067468815903482,108880,24825,24825,27525,0.038886567116197576,0.7265241991223699,0.2345892337614325
2020-09-22,160,3501,252923,9837,184298,58788,4071,0.13104780299372285,0.01635912108401781,109721,31065,31065,43896,0.03889326000403285,0.7286723627349035,0.23243437726106364
2020-09-23,140,3660,257388,9977,187958,59453,4465,0.1751117734724292,0.017653594176883874,109541,25498,25498,38181,0.038762490869815217,0.7302516045814101,0.2309859045487746
2020-09-24,128,3895,262022,10105,191853,60064,4634,0.13321451158512046,0.01800394734797271,110910,34786,34786,42564,0.038565463968674385,0.7322018761783362,0.22923265985298946
2020-09-25,113,4343,266845,10218,196196,60431,4823,0.18255800749460616,0.01840685133309417,112082,26419,26419,46133,0.03829189229702636,0.7352433060390864,0.2264648016638873
2020-09-26,90,3207,271339,10308,199403,61628,4494,0.1751500506664588,0.016841237422473718,119379,25658,25658,48836,0.037989378600201226,0.7348851436763606,0.22712547772343825
2020-09-27,78,3611,275213,10386,203014,61813,3874,0.18625,0.014277343102171084,129553,20800,20800,37272,0.037738042897682886,0.7376613750077213,0.22460058209459585
2020-09-28,87,3856,278722,10473,206870,61379,3509,0.12696747114375656,0.012750124449063087,131361,27637,27637,32189,0.03757507480572039,0.7422090828854557,0.22021584230882385
2020-09-29,128,3567,282724,10601,210437,61686,4002,0.14348714639130902,0.014358392950682041,132496,27891,27891,37158,0.03749593242879982,0.7443195483934862,0.21818451917771395
2020-09-30,139,4510,287008,10740,214947,61321,4284,0.13846153846153847,0.015152586975283315,132693,30940,30940,45496,0.037420559705652806,0.7489233749581893,0.21365606533615789
2020-10-01,116,3540,291182,10856,218487,61839,4174,0.13777396355954585,0.0145431486230349,135480,30296,30296,43592,0.037282524331861175,0.7503451449608836,0.21237233070725525
2020-10-02,116,2853,295499,10972,221340,63187,4317,0.16089597853229473,0.014825779066013697,135348,26831,26831,42421,0.037130413300891035,0.7490380678107201,0.2138315188883888
2020-10-03,83,3712,299506,11055,225052,63399,4007,0.16611392090208107,0.0135601135706043,139099,24122,24122,43487,0.036910779750656084,0.7514106562138989,0.21167856403544505
2020-10-04,96,3401,303498,11151,228453,63894,3992,0.18446467353634305,0.013328614451797291,139401,21641,21641,36743,0.03674159302532471,0.7527331316845579,0.2105252752901172
2020-10-05,102,4140,307120,11253,232593,63274,3622,0.15906196477976373,0.01193418078537585,141169,22771,22771,27024,0.036640401146131804,0.7573358947642616,0.20602370408960666
2020-10-06,121,3844,311176,11374,236437,63365,4056,0.15508737047375062,0.013206564209429537,140305,26153,26153,36342,0.03655166208190863,0.7598175951872895,0.20363074273080187
2020-10-07,98,3854,315714,11472,240291,63951,4538,0.1410762582771163,0.014583386893590766,142213,32167,32167,44212,0.03633668446758776,0.7611034037134875,0.20255991181892471
2020-10-08,108,3769,320564,11580,244060,64924,4850,0.14741193276800094,0.015362004852493082,144072,32901,32901,43389,0.036123831746546715,0.7613456283300682,0.20253053992338504
2020-10-09,97,3607,324658,11677,247667,65314,4094,0.10465770233652028,0.012771240688286894,149115,39118,39118,44700,0.03596707920334629,0.7628550659463189,0.2011778548503348
2020-10-10,88,3814,328952,11765,251481,65706,4294,0.12751299183370454,0.013226225751406095,151652,33675,33675,42668,0.0357650964274423,0.7644914759600184,0.1997434276125392
2020-10-11,79,3546,333449,11844,255027,66578,4497,0.20290574380724632,0.013670687516719763,152286,22163,22163,36332,0.03551967467288851,0.7648156089836826,0.1996647163434289
2020-10-12,91,3492,336716,11935,258519,66262,3267,0.0989460294384881,0.009797600232719248,154532,33018,33018,39285,0.035445301084593546,0.7677657135390061,0.1967889853764003
2020-10-13,92,4777,340622,12027,263296,65299,3906,0.09762071378586423,0.011600280354957887,153822,40012,40012,50418,0.03530893483098567,0.7729858905179349,0.1917051746510795
2020-10-14,129,4555,344749,12156,267851,64742,4127,0.11140805528560632,0.012116070013093694,154420,37044,37044,40393,0.035260435853330975,0.7769449657576962,0.1877945983889729
2020-10-15,112,5810,349160,12268,273661,63231,4411,0.129282804302588,0.012794815938552395,154926,34119,34119,42208,0.03513575438194524,0.7837696185130026,0.1810946271050521
2020-10-16,79,3883,353461,12347,277544,63570,4301,0.14243136735437295,0.012318134952457326,157672,30197,30197,41541,0.03493171806790565,0.7852181711702281,0.17985011076186624
2020-10-17,84,4048,357762,12431,281592,63739,4301,0.1655759162303665,0.012168244870013948,158700,25976,25976,43305,0.03474656335776298,0.7870930954097975,0.17816034123243946
2020-10-18,80,3732,361867,12511,285324,64032,4105,0.18308728424245127,0.011474108485529488,159715,22421,22421,36378,0.034573475890313295,0.7884775345638039,0.17694898954588287
